10 10
##########
#.###...##
#.###...##
#........#
##.......#
####.....#
#####....#
..........
#.....####
###.######
7 7 5
L 10
L 1
L 3
P 5
P 5